0000000000000000000000000000
0111111111111001111111111110
0100001000001001000001000010
0102201022201001022201022010
0100001000001001000001000010
0111111111111111111111111110
0100001001000000001001000010
0100001001000000001001000010
0111111001111001111001111110
0000001000001001000001000000
2222201000001001000001022222
2222201001111111111001022222
2222201001000000001001022222
0000001001022222201001000000
3111111111022222201111111113
0000001001022222201001000000
2222201001000000001001022222
2222201001111111111001022222
2222201001000000001001022222
0000001001000000001001000000
0111111111111001111111111110
0100001000001001000001000010
0100001000001001000001000010
0111001111111111111111001110
0001001001000000001001001000
0001001001000000001001001000
0111111001111001111001111110
0100000000001001000000000010
0100000000001001000000000010
0111111111111111111111111110
0000000000000000000000000000