000000000000000
000000030000000
000001000300000
000000030000000
000001000300000
000100020003000
010001000200030
000100020003000
000001000200000
000000020000000
000000000000000
000000000000000
000000000000000
000000000000000
000000000000000