000000000000000
000001000000000
000100010000000
020001000000000
000200010000000
020002000000000
000000030000000
030002000000000
000300030000000
000003000000000
000000000000000
000000000000000
000000000000000
000000000000000
000000000000000