000000000000000
000000010000000
000001000000000
000100010000000
010001000100000
000200010001000
010001000100000
000100010001000
000001000100000
000000010000000
000000000000000
000000000000000
000000000000000
000000000000000
000000000000000
