000000000000000
010000000200000
000100010000000
010001000200000
000000000000000
010002000200000
000100020000000
000002000000000
000000000000000
000002000000000
000300030000000
030003000300000
000300030000000
000000000000000
000000000000000
