000000000000000
000000000000040
000000010004000
000001000400040
000100010004000
000000000300040
000100020003000
000001000200030
000000010003000
000000000000030
000000000000000
000000000000000
000000000000000
000000000000000
000000000000000