01000000
00010001
01000100
00000000
01000000
00010000