000000000000000
000000020000000
000001000000000
000100020000000
010001000300000
000000020003000
010002000300000
000100020003000
000002000300000
000000020000000
000000000000000
000000000000000
000000000000000
000000000000000
000000000000000