000000000000000
000100030000000
010003000000000
000100030000000
010003000300000
000100040000000
020004000400000
000200040000000
020002000000000
000200040000000
000000000000000
000000000000000
000000000000000
000000000000000
000000000000000